E,E,E,E,E,E,E,E,E,E,E,E,E,E,E,E,E,E,E,E,E,E,E,E,E,E,E,E,E,E,E,E,E,E,E,E,E,E,E,E,E,E,E,E,E,E,E,E,E,E
E,E,E,E,E,E,E,E,E,F,F,F,F,F,F,F,E,F,E,F,F,F,F,F,F,F,E,F,F,F,F,F,F,F,F,F,F,F,F,F,F,F,E,E,E,E,E,E,E,E
E,E,E,E,E,E,E,E,E,F,F,F,F,F,F,F,E,F,E,F,E,E,E,E,E,F,E,F,E,F,E,E,E,F,F,F,F,F,F,F,E,F,E,E,E,E,E,E,E,E
E,F,F,F,E,F,F,F,F,F,F,F,F,F,F,F,E,F,F,F,F,F,F,F,E,F,E,F,E,F,E,F,F,F,F,F,F,F,F,F,E,F,E,E,E,E,E,E,E,E
E,F,E,E,E,F,E,E,E,F,F,F,F,F,F,F,E,E,E,E,E,E,E,E,E,F,E,F,E,F,E,F,E,F,F,F,F,F,F,F,E,F,E,E,E,E,E,E,E,E
E,F,E,F,F,F,F,F,F,F,F,F,F,F,F,F,F,F,E,F,F,F,F,F,F,F,E,F,E,F,E,F,F,F,F,F,F,F,F,F,F,F,E,F,F,F,F,F,E,E
E,F,E,F,E,E,E,E,E,F,E,E,E,E,E,E,E,F,E,F,F,F,E,E,E,F,E,F,E,F,E,F,E,F,F,F,F,F,F,F,E,E,E,F,E,E,E,F,E,E
E,F,E,F,E,F,F,F,F,F,F,F,F,F,F,F,E,F,F,F,F,F,E,F,F,F,E,F,E,F,E,F,E,F,F,F,F,F,F,F,E,F,E,F,E,E,E,F,E,E
E,F,E,F,E,F,F,F,F,F,F,F,F,F,F,F,E,E,E,E,E,E,E,E,E,E,E,F,E,F,E,E,E,E,E,F,E,E,E,E,E,F,E,F,E,E,E,F,E,E
E,F,E,F,E,F,F,F,F,F,F,F,F,F,F,F,F,F,F,F,F,F,F,F,F,F,F,F,E,F,E,E,E,E,E,F,F,F,E,F,F,F,F,F,E,E,E,F,E,E
E,F,E,F,E,E,E,F,E,E,E,E,E,E,E,E,E,E,E,E,E,E,E,E,E,E,E,E,E,F,E,E,E,E,E,E,E,F,E,F,F,F,F,F,E,E,E,F,E,E
E,F,E,F,F,F,F,F,E,F,F,F,F,F,F,F,F,F,F,F,F,F,F,F,F,F,F,F,F,F,E,E,E,E,E,F,E,F,E,F,F,F,F,F,E,E,E,F,F,F
E,F,E,E,E,E,E,E,E,F,F,F,E,E,E,E,E,E,E,F,F,F,F,F,E,E,E,E,E,E,E,E,E,E,E,F,E,F,E,E,E,E,E,E,E,E,E,E,E,F
E,F,E,E,E,E,E,E,E,F,F,F,E,F,F,F,F,F,E,F,F,F,F,F,E,F,F,F,F,F,F,F,F,F,F,F,E,F,E,F,F,F,F,F,F,F,F,F,F,F
E,F,E,E,E,E,E,E,E,F,F,F,E,F,E,E,E,F,E,F,F,F,F,F,E,F,E,E,E,E,E,E,E,F,E,E,E,F,E,E,E,F,E,E,E,E,E,E,E,F
E,F,F,F,F,F,F,F,E,F,F,F,E,F,E,F,F,F,E,F,F,F,F,F,F,F,F,F,E,E,E,E,E,F,E,F,F,F,F,F,F,F,F,F,F,F,F,F,E,F
E,E,E,E,E,E,E,F,E,F,F,F,E,F,E,E,E,E,E,E,E,E,E,E,E,E,E,F,E,E,E,E,E,F,E,F,F,F,F,F,F,F,F,F,F,F,E,F,E,F
E,E,E,E,E,E,E,F,E,F,F,F,E,F,F,F,F,F,E,E,E,E,E,F,F,F,F,F,E,E,E,E,E,F,E,F,F,F,F,F,F,F,F,F,F,F,E,F,E,F
E,E,E,E,E,E,E,F,E,F,F,F,E,F,E,E,E,F,E,E,E,E,E,F,E,F,F,F,E,E,E,E,E,F,E,E,E,E,E,E,E,E,E,E,E,F,E,F,E,F
E,E,E,E,E,E,E,F,F,F,F,F,E,F,E,E,E,F,E,E,E,E,E,F,E,F,F,F,E,F,F,F,E,F,F,F,F,F,F,F,F,F,E,F,F,F,E,F,E,F
E,E,E,E,E,E,E,E,E,E,E,E,E,F,E,E,E,F,E,E,E,E,E,F,E,F,F,F,E,F,F,F,E,F,E,E,E,E,E,E,E,F,E,F,E,E,E,F,E,F
E,E,E,E,E,F,F,F,E,E,E,E,E,F,E,E,E,F,F,F,F,F,F,F,E,F,F,F,F,F,F,F,E,F,E,F,E,F,F,F,E,F,E,F,E,E,E,F,F,F
E,E,E,E,E,F,F,F,E,E,E,E,E,F,E,E,E,E,E,E,E,E,E,E,E,F,F,F,E,E,E,E,E,F,E,F,E,F,F,F,E,F,E,F,E,E,E,E,E,E
E,E,E,E,E,F,F,F,E,F,F,F,F,F,E,E,E,F,F,F,F,F,F,F,E,F,F,F,E,F,F,F,E,F,E,F,F,F,F,F,E,F,E,F,E,F,F,F,F,F
E,E,E,E,E,F,F,F,E,F,E,E,E,E,E,E,E,F,E,F,F,F,E,F,E,E,E,E,E,F,E,E,E,F,E,F,E,F,F,F,E,F,E,F,E,F,E,E,E,F
E,E,E,E,E,F,F,F,E,F,E,F,F,F,F,F,F,F,E,F,F,F,E,F,F,F,E,F,F,F,F,F,E,F,E,F,E,F,F,F,E,F,E,F,E,F,E,E,E,F
E,E,E,E,E,E,E,F,E,F,E,F,E,F,F,F,F,F,E,F,F,F,E,E,E,F,E,F,F,F,F,F,E,F,E,F,E,F,F,F,E,F,E,F,E,F,E,E,E,F
E,F,F,F,F,F,F,F,E,F,E,F,E,F,F,F,F,F,E,F,F,F,E,E,E,F,E,F,F,F,F,F,E,F,E,F,E,F,F,F,E,F,E,F,E,F,F,F,E,F
E,F,E,E,E,E,E,E,E,F,E,F,E,F,F,F,F,F,E,F,F,F,E,E,E,F,E,F,F,F,F,F,E,F,E,F,E,F,F,F,E,F,E,F,E,E,E,F,E,F
E,F,F,F,F,F,F,F,F,F,E,F,E,F,F,F,F,F,E,F,F,F,E,E,E,F,F,F,F,F,F,F,E,F,E,F,E,F,F,F,F,F,E,F,E,F,F,F,E,F
E,F,E,E,E,E,E,E,E,E,E,F,E,F,F,F,F,F,E,F,F,F,E,E,E,F,E,F,F,F,F,F,E,F,E,F,E,E,E,E,E,E,E,F,E,E,E,F,E,F
E,F,F,F,E,E,E,E,E,E,E,F,E,F,F,F,F,F,E,F,F,F,F,F,F,F,E,F,F,F,F,F,E,F,E,F,E,E,E,E,E,E,E,F,F,F,E,F,E,F
E,F,F,F,E,E,E,E,E,E,E,F,E,F,F,F,F,F,E,F,E,E,E,E,E,F,E,E,E,E,E,E,E,F,E,F,E,E,E,E,E,E,E,E,E,F,E,F,E,F
E,F,F,F,E,E,E,E,E,F,F,F,E,F,F,F,F,F,E,F,F,F,E,E,E,F,F,F,F,F,F,F,E,F,F,F,F,F,F,F,F,F,F,F,E,F,E,F,E,F
E,F,F,F,E,E,E,E,E,F,E,E,E,F,F,F,F,F,E,E,E,F,E,E,E,E,E,E,E,E,E,F,E,F,F,F,F,F,F,F,F,F,F,F,E,F,E,F,E,F
E,F,F,F,E,F,F,F,F,F,F,F,E,F,F,F,F,F,E,F,E,F,E,E,E,F,F,F,F,F,E,F,E,F,F,F,F,F,F,F,F,F,F,F,E,F,E,F,E,F
E,F,F,F,E,F,F,F,E,E,E,F,E,E,E,F,E,E,E,F,E,F,E,E,E,F,F,F,F,F,E,F,E,F,F,F,F,F,F,F,F,F,F,F,E,F,E,F,E,F
E,F,F,F,F,F,F,F,E,F,F,F,F,F,F,F,F,F,F,F,E,F,E,E,E,F,F,F,F,F,E,F,E,F,F,F,F,F,F,F,F,F,F,F,E,F,E,F,E,F
E,F,F,F,E,E,E,E,E,E,E,E,E,E,E,E,E,E,E,E,E,F,E,E,E,F,F,F,F,F,E,F,E,F,F,F,F,F,F,F,F,F,F,F,E,F,E,F,E,F
E,F,F,F,E,E,E,F,F,F,F,F,F,F,F,F,F,F,F,F,E,F,E,E,E,F,F,F,F,F,E,F,E,F,F,F,F,F,F,F,F,F,F,F,E,F,E,F,E,F
E,F,F,F,E,E,E,F,E,E,E,E,E,E,E,E,E,E,E,F,E,F,E,E,E,F,F,F,F,F,E,F,E,E,E,E,E,E,E,E,E,F,E,E,E,F,E,E,E,F
E,F,F,F,F,F,E,F,E,F,F,F,E,E,E,E,E,E,E,F,F,F,E,E,E,F,F,F,F,F,E,F,E,E,E,E,E,F,F,F,F,F,E,E,E,F,F,F,F,F
E,F,E,E,E,F,E,F,E,F,F,F,E,E,E,E,E,E,E,E,E,E,E,E,E,E,E,E,E,F,E,F,E,E,E,E,E,F,E,E,E,E,E,E,E,E,E,E,E,F
E,F,E,F,F,F,E,F,E,F,F,F,E,E,E,F,F,F,F,F,E,F,F,F,F,F,F,F,F,F,E,F,E,E,E,E,E,F,F,F,F,F,F,F,F,F,F,F,F,F
E,F,E,E,E,E,E,F,E,F,F,F,E,E,E,F,F,F,F,F,E,F,E,E,E,E,E,E,E,E,E,F,E,E,E,E,E,F,F,F,E,E,E,E,E,E,E,E,E,E
E,F,E,E,E,F,F,F,E,F,F,F,F,F,F,F,F,F,F,F,F,F,F,F,F,F,F,F,F,F,F,F,E,E,E,E,E,F,F,F,E,F,F,F,F,F,F,F,E,E
E,F,E,E,E,F,E,E,E,F,F,F,E,F,E,E,E,E,E,E,E,E,E,E,E,E,E,E,E,E,E,E,E,E,E,E,E,E,E,E,E,E,E,E,E,F,E,F,E,E
E,F,E,E,E,F,E,F,E,F,F,F,E,F,E,F,F,F,F,F,E,E,E,F,F,F,F,F,F,F,F,F,F,F,E,F,F,F,F,F,F,F,F,F,E,F,E,F,E,E
E,F,E,E,E,F,E,F,E,E,E,E,E,F,E,E,E,F,E,F,E,E,E,F,E,E,E,E,E,E,E,E,E,F,E,F,E,E,E,E,E,E,E,F,E,E,E,F,E,E
E,F,F,F,F,F,E,F,F,F,F,F,F,F,F,F,F,F,E,F,F,F,F,F,E,F,F,F,F,F,F,F,F,F,F,F,E,E,E,E,E,E,E,F,F,F,F,F,E,E